Liam	M
Olivia	F
Noah	M
Emma	F
Oliver	M
Ava	F
Elijah	M
Charlotte	F
William	M
Sophia	F
James	M
Amelia	F
Benjamin	M
Isabella	F
Lucas	M
Mia	F
Henry	M
Evelyn	F
Alexander	M
Harper	F
Mason	M
Camila	F
Michael	M
Gianna	F
Ethan	M
Abigail	F
Daniel	M
Luna	F
Jacob	M
Ella	F
Logan	M
Elizabeth	F
Jackson	M
Sofia	F
Levi	M
Emily	F
Sebastian	M
Avery	F
Mateo	M
Mila	F
Jack	M
Scarlett	F
Owen	M
Eleanor	F
Theodore	M
Madison	F
Aiden	M
Layla	F
Samuel	M
Penelope	F
Joseph	M
Aria	F
John	M
Chloe	F
David	M
Grace	F
Wyatt	M
Ellie	F
Matthew	M
Nora	F
Luke	M
Hazel	F
Asher	M
Zoey	F
Carter	M
Riley	F
Julian	M
Victoria	F
Grayson	M
Lily	F
Leo	M
Aurora	F
Jayden	M
Violet	F
Gabriel	M
Nova	F
Isaac	M
Hannah	F
Lincoln	M
Emilia	F
Anthony	M
Zoe	F
Hudson	M
Stella	F
Dylan	M
Everly	F
Ezra	M
Isla	F
Thomas	M
Leah	F
Charles	M
Lillian	F
Christopher	M
Addison	F
Jaxon	M
Willow	F
Maverick	M
Lucy	F
Josiah	M
Paisley	F
